county,gop,dem,population,,county,gop,dem,population
5001,3825,2342,6167,,1001,18110,5908,24661
5041,1915,2311,4226,,1021,15068,2909,18255
5079,2455,1359,3814,,1007,6733,1874,8748
5069,9231,16452,25683,,1065,3172,4772,8010
5085,19902,6864,26766,,1063,838,4006,4862
5117,2503,901,3404,,1091,5224,5607,10948
5095,1400,1366,2766,,1023,4102,3109,7268
5107,2443,4451,6894,,1025,7109,5712,12936
5077,1229,1775,3004,,1003,72780,18409,94090
5035,6953,8845,15798,,1053,10282,4698,15213
5037,4577,2254,6831,,1035,3413,3069,6543
5067,3262,1831,5093,,1013,4891,3716,8685
5031,22798,12170,34968,,1039,13222,2379,15818
5055,10698,3724,14422,,1031,15825,4194,20513
5021,3779,2199,5978,,1041,4511,1663,6252
5121,4508,1805,6313,,1085,1751,4882,6676
5075,4064,1565,5629,,1047,5784,12826,18730
5063,9925,3518,13443,,1105,1403,3823,5255
5023,9454,2514,11968,,1131,1737,4329,6095
5045,29170,17194,46364,,1099,5771,4310,10185
5029,4844,2993,7837,,1101,33928,58669,94572
5105,2979,1234,4213,,1011,1139,3530,4701
5051,26053,14284,40337,,1005,5431,4848,10390
5059,8153,3662,11815,,1045,13798,4408,18617
5019,4398,3967,8365,,1061,9967,1522,11659
5039,1507,1234,2741,,1069,30567,10547,42030
5013,1554,696,2250,,1067,5623,2286,8017
5011,2163,1454,3617,,13061,566,697,1271
5003,5338,2689,8027,,13037,829,1178,2023
5017,1716,2433,4149,,13007,775,650,1440
5043,3967,2585,6552,,13087,6009,4104,10238
5025,2460,839,3299,,13131,6047,3005,9187
5053,5160,1695,6855,,13205,4272,3492,7857
5119,61182,96546,157728,,13071,9892,3460,13592
5125,35852,16119,51971,,13027,3679,2504,6268
22035,1059,1880,2939,,13075,4175,1752,6038
22065,1927,2805,4732,,13019,5408,1041,6563
22041,6514,2648,9162,,13003,1873,696,2604
22021,3822,870,4692,,13065,1724,685,2443
22025,3479,1377,4856,,13101,1006,156,1175
22009,11163,5418,16581,,13173,1984,805,2861
22029,5474,3395,8869,,13185,21308,14614,36813
22077,6789,4972,11761,,13299,8508,3436,12150
22047,7320,8723,16043,,13005,3356,607,4010
22005,36135,18528,54663,,13001,5492,1434,7003
22007,6714,4190,10904,,13161,4102,901,5089
22045,20903,11551,32454,,13069,9575,4090,13896
22055,68191,37408,105599,,13017,3734,2098,5923
22001,21159,6227,27386,,13155,2711,890,3659
22039,10357,4522,14879,,13277,8680,3892,12796
22003,6867,2378,9245,,13287,2094,1243,3390
22011,12238,2840,15078,,13081,4539,2835,7500
22019,54182,29591,83773,,13093,1941,1860,3836
22023,3256,436,3692,,13153,35351,22460,59559
22053,10775,3502,14277,,13021,22589,34383,58327
22113,19807,5446,25253,,13079,3632,1419,5157
48245,42828,44535,87363,,13193,1540,2705,4287
48071,13278,3383,16661,,13225,5405,5083,10699
48167,73566,50428,123994,,13269,2062,1295,3402
48039,72653,47643,120296,,13197,1921,1213,3183
48157,117212,143155,260367,,13053,746,593,1384
48015,9637,2618,12255,,1113,9210,9577,19136
48089,6323,2157,8480,,1081,34321,20987,57668
48149,8648,2381,11029,,1017,7803,5763,13778
48021,16314,11936,28250,,1111,7697,2290,10130
48055,6516,5193,11709,,1027,5230,1234,6572
48177,4580,1724,6304,,1029,5738,684,6532
48123,5510,1312,6822,,1015,32803,13197,47376
48175,2618,1095,3713,,1019,8809,1524,10503
48025,4743,3715,8458,,1049,21779,3682,26086
48255,2959,1226,4185,,1055,32132,10350,43474
48013,8598,5007,13605,,1009,22808,2150,25384
48029,240161,345877,586038,,1043,32734,3730,37278
48019,8159,2054,10213,,1079,10732,3611,14623
48259,15663,4273,19936,,1033,16718,7296,24626
48031,4212,1457,5669,,1059,9466,2197,11955
48053,14595,4451,19046,,1093,11273,1432,12912
48027,51780,42219,93999,,1057,6705,1358,8196
48099,12212,5915,18127,,1075,5819,1035,6931
48035,6325,1472,7797,,1107,5454,3972,9494
48143,11205,2605,13810,,1119,1581,4739,6391
48093,4300,908,5208,,28069,1778,2827,4639
48049,12010,1939,13949,,28075,17574,10910,28967
48059,4858,698,5556,,28023,5088,2556,7713
48083,3177,458,3635,,28061,4032,4367,8468
48095,885,182,1067,,28067,20076,7748,28250
48307,2546,540,3086,,28031,5423,3267,8790
48319,1656,397,2053,,28035,15149,11271,27284
48171,10445,2678,13123,,28073,18493,5044,24179
48265,17658,5432,23090,,28065,2466,3720,6237
48137,741,324,1065,,28077,4072,2181,6329
48267,1697,248,1945,,28029,5576,6203,11906
48327,681,179,860,,28021,414,2523,2954
48413,819,235,1054,,28049,24919,64922,91536
48105,980,415,1395,,28089,25607,18358,45048
48103,1047,334,1381,,28007,4288,2847,7242
48135,24976,11397,36373,,28015,3774,1648,5470
48003,3925,1001,4926,,28043,5940,4386,10442
48165,3907,702,4609,,28013,4360,1884,6339
48115,2636,926,3562,,28017,4127,3649,7890
48033,330,35,365,,28025,4136,5695,9960
48169,1223,252,1475,,28087,13124,11545,25139
48107,1180,532,1712,,28095,10107,5485,15781
48125,755,154,909,,28057,8385,1100,9634
48101,486,97,583,,28081,21695,9635,31974
48075,1802,282,2084,,28115,9442,2123,11811
40057,714,261,975,,28071,10872,7968,19642
40009,6287,1242,7529,,28093,6525,7944,14698
40039,7818,2713,10531,,28009,2240,1713,3996
40011,2884,909,3793,,28139,7182,1808,9143
40015,6473,2863,9336,,28003,11817,2684,14781
40017,39969,15281,55250,,28117,7647,2067,9871
40027,62469,46857,109326,,28141,7117,990,8310
40087,13151,3688,16839,,1077,27735,9877,38813
40049,8243,2288,10531,,1083,28824,9340,39400
40019,13751,4782,18533,,1089,89199,62435,159473
40067,1905,440,2345,,1071,16643,3663,20785
40033,2054,548,2602,,1095,29217,4913,34965
40031,19153,13351,32504,,1103,37392,11216,49991
40051,17293,4964,22257,,47051,11526,4372,16363
40137,14166,3720,17886,,47031,14409,4741,19895
40075,2593,896,3489,,47003,11455,3384,15300
40055,1482,414,1896,,47103,10375,2550,13270
40065,5969,1837,7806,,47055,7964,2915,11120
40141,1944,762,2706,,47099,12419,2821,15658
48485,27609,10304,37913,,47101,3579,890,4601
48009,3785,484,4269,,47081,5685,1823,7762
48023,1267,225,1492,,47043,13213,4718,18619
48155,383,128,511,,47021,11295,3877,15823
48197,1207,304,1511,,47037,84365,148473,246199
48487,3166,935,4101,,47147,19393,6634,27042
48269,149,10,159,,47125,32320,21686,57278
48207,1403,362,1765,,47083,2180,865,3165
48253,4815,1117,5932,,47005,4715,1474,6322
48151,1265,457,1722,,47017,7731,2323,10333
48263,360,73,433,,47039,3580,894,4577
48415,4403,858,5261,,47071,8012,1622,9949
48335,1780,410,2190,,47023,3827,902,4850
48081,1265,158,1423,,47069,4912,4174,9242
48353,3551,1193,4744,,47047,13046,5865,19306
48399,3241,524,3765,,47075,3010,3704,6824
48441,33172,12094,45266,,47033,3977,1302,5386
48451,27376,10728,38104,,47045,10175,2815,13290
48235,660,100,760,,47053,13779,5255,19484
48383,709,191,900,,47113,21321,15438,37764
48173,553,49,602,,47077,8118,1796,10172
48227,6635,2057,8692,,47131,9525,2425,12223
48317,1453,302,1755,,47095,1357,577,1970
48329,36896,11857,48753,,47183,9001,2770,12127
48461,961,335,1296,,47079,9483,3061,12887
48431,549,84,633,,47161,3864,1222,5283
48433,555,146,701,,47097,4884,3656,8678
48275,1078,280,1358,,47167,16893,5779,23372
48447,715,93,808,,47157,114948,206640,331861
48417,1378,124,1502,,28033,42155,19892,64022
48133,6008,927,6935,,28137,7385,3804,11389
48363,8222,1953,10175,,28107,7371,7300,14854
48221,21367,4753,26120,,28119,998,2303,3353
48251,44370,12900,57270,,28027,2426,6378,8912
48139,44807,18257,63064,,28011,4251,8410,12831
48113,261865,488784,750649,,28133,2768,6560,9406
48085,200395,156150,356545,,28053,924,2652,3599
48121,169175,124112,293287,,28051,1151,5820,7045
48097,13174,2720,15894,,28083,2757,6677,9566
40085,2920,867,3787,,28135,2462,3337,5870
40095,4202,1285,5487,,28161,3366,2574,6058
40013,10449,3326,13775,,28163,4568,5221,9892
40005,4068,934,5002,,28055,298,395,699
40023,4202,1217,5419,,28125,619,1290,1926
40089,8642,2067,10709,,28151,4541,9847,14571
5081,3604,1588,5192,,28149,9420,8518,18287
5057,4391,2593,6984,,28143,840,2577,3463
5061,3155,1479,4634,,47109,7839,1847,10035
5097,2573,872,3445,,47181,5034,717,5842
5109,3150,806,3956,,47135,2167,597,2855
5099,2001,1232,3233,,47085,4928,1967,7139
5027,5456,3381,8837,,47165,50105,18153,71080
5073,1750,1085,2835,,47111,6260,1071,7490
5091,11293,4722,16015,,47027,2140,707,2919
22015,35451,14367,49818,,47087,3229,1129,4447
22013,3756,3249,7005,,47133,6055,1943,8195
22027,3585,2836,6421,,47049,6032,1100,7311
5139,10201,6137,16338,,47035,20410,5202,26298
5103,5347,4534,9881,,47007,3621,896,4650
22067,6502,5350,11852,,47065,78661,55260,141088
22073,41712,26275,67987,,47011,29761,7070,38392
22049,5169,2295,7464,,47107,14673,3507,18694
22061,10761,7903,18664,,47105,17588,4916,23304
22111,7972,2922,10894,,47009,37385,12085,51849
22127,4605,1763,6368,,47093,105724,62861,179266
22043,7406,1413,8819,,47001,19201,9010,29723
22059,5835,733,6568,,47013,9860,2248,12504
22079,36814,20024,56838,,47025,8589,1831,10706
22069,8965,7652,16617,,47057,6618,1154,7985
22031,8067,5430,13497,,47063,15839,4075,20579
22017,48977,56760,105737,,47029,9791,1980,12108
22081,2391,2031,4422,,47059,18538,4211,23491
48067,9182,2424,11606,,47073,16611,3502,20694
48037,24913,9557,34470,,47067,1842,322,2229
48343,3443,1521,4964,,47163,45577,11910,59860
48063,3201,1341,4542,,47019,16897,3453,20993
48159,3583,773,4356,,47091,5400,988,6556
48119,1836,443,2279,,47171,5666,1260,7166
48147,9536,2436,11972,,47179,34179,13003,49411
48181,35274,11794,47068,,47089,14760,3490,18994
48231,23866,7319,31185,,47155,28610,6293,36180
48223,10704,2772,13476,,47173,5024,1010,6204
48379,3919,711,4630,,47151,6044,934,7123
48467,18436,3253,21689,,47129,5429,1053,6664
48213,23574,6281,29855,,47145,15863,4833,21580
48001,13165,3722,16887,,47121,3337,856,4311
48073,12896,3805,16701,,47143,8650,1942,10946
48005,21666,8204,29870,,47137,2019,536,2609
48225,6205,2097,8302,,47123,13361,3184,17050
48289,6391,1016,7407,,47139,5097,1252,6520
48041,38662,27374,66036,,13111,9622,1920,11764
48051,5316,1629,6945,,13085,9880,1444,11680
48287,4996,1526,6522,,13057,80611,25203,110825
48331,6340,2267,8607,,13015,29879,8204,39263
48145,3438,1794,5232,,13067,152602,159416,326424
48293,5747,1901,7648,,13097,24803,30971,57365
48161,5995,1613,7608,,13045,29983,12422,43744
48349,11984,4398,16382,,13077,42513,16572,61315
48217,10075,2831,12906,,13113,35034,23255,60387
48309,48245,30010,78255,,13063,11740,75908,89236
48395,4665,2345,7010,,13089,47531,239131,295871
48313,3349,934,4283,,13121,110372,281875,407173
48185,7065,2463,9528,,13117,69801,23427,97314
48339,150188,52895,203083,,13135,146463,165063,323931
48201,544960,757927,1302887,,13013,21105,6580,28828
48291,18856,5299,24155,,13059,12691,29514,44221
48199,19600,3168,22768,,13157,21754,4469,27057
48241,10578,2773,13351,,13011,6130,684,6946
48351,2961,1049,4010,,13119,7054,1243,8474
22085,7877,1908,9785,,13147,7285,2583,10077
22115,13471,3162,16633,,13105,5269,2507,7912
48403,3992,650,4642,,13181,2759,1271,4100
48405,2620,943,3563,,13073,43060,18863,64190
48347,14751,7679,22430,,13189,5432,3699,9268
48401,14675,4319,18994,,13163,3057,3809,6934
48183,28693,12672,41365,,13033,4491,4730,9350
48203,18712,7652,26364,,13107,5330,2433,7838
48315,2968,1238,4206,,13031,14476,8812,24151
48459,13198,2720,15918,,13029,10513,4010,15063
48423,58631,24530,83161,,13051,43649,58998,106013
48499,15681,2965,18646,,13103,17865,4851,23395
48365,8445,1968,10413,,13251,3305,2300,5699
48419,7171,1901,9072,,13165,1892,1108,3034
48361,25385,6376,31761,,13179,6125,9531,16082
48457,6601,1368,7969,,13109,2404,1130,3602
48373,26587,7857,34444,,13043,2661,1023,3757
48407,8050,2255,10305,,13267,5092,1678,6879
48455,4737,1245,5982,,13183,2623,1356,4109
48471,12878,6805,19683,,13191,3482,2298,5893
48473,10525,6190,16715,,13127,21482,11738,34041
48477,10944,3803,14747,,13025,5561,619,6285
48491,104029,96495,200524,,13039,12287,5914,18825
48453,126750,335761,462511,,13049,2950,1004,4008
48209,33730,37794,71524,,13229,6301,903,7297
48091,44996,16571,61567,,13305,8147,2039,10376
48187,36495,20725,57220,,13279,6612,2338,9108
48493,13991,5264,19255,,13209,2668,847,3560
48257,29537,11442,40979,,13283,1808,860,2700
48397,28396,11133,39529,,13167,2519,1136,3682
48277,14546,3991,18537,,13175,12401,6737,19448
48387,3924,1223,5147,,13023,3717,1094,4934
48449,6405,2771,9176,,13091,5021,1836,6995
22083,6286,3310,9596,,13235,2436,1104,3598
22123,3970,789,4759,,13315,2096,852,2973
22119,11538,6602,18140,,13271,2449,1313,3794
5113,6606,1515,8121,,13309,1421,646,2102
5127,2378,639,3017,,13289,2034,1970,4053
5083,5737,2102,7839,,13169,8304,3960,12524
5047,5034,1664,6698,,13009,7691,7965,16075
5033,16655,5500,22155,,13141,841,2695,3572
5087,4917,1865,6782,,13125,1235,138,1390
5007,60751,33511,94262,,13301,991,1313,2332
5015,6773,3883,10656,,13265,349,545,897
5009,12225,3687,15912,,13133,5488,3194,8831
5089,5077,1641,6718,,13211,6559,2658,9435
5005,14655,4917,19572,,13159,4353,1544,6016
5049,3470,1274,4744,,13035,6717,2566,9477
5065,4042,1354,5396,,13151,45641,49902,98037
5135,5405,1785,7190,,13217,20907,21936,43787
29149,3668,996,4664,,13247,13463,23206,37589
29035,2323,519,2842,,13297,31093,8279,40425
29023,13647,3585,17232,,13219,12885,5253,19030
29069,8026,2548,10574,,13221,4622,1829,6650
5093,6988,6007,12995,,13195,9195,2423,11945
5111,3149,2134,5283,,13317,2569,1844,4470
29155,3964,2061,6025,,13255,15636,9347,25940
29143,5270,2082,7352,,13171,5183,2267,7575
29133,3600,1565,5165,,13207,8821,3570,12675
29201,13168,4076,17244,,13293,7288,3471,10924
29031,26939,9936,36875,,13199,5216,3800,9181
29017,4827,842,5669,,13145,11931,4082,16392
29123,4102,1216,5318,,13215,26901,39602,68320
29093,3173,1087,4260,,13263,1196,2001,3243
29055,7724,2196,9920,,13285,15643,9597,25793
29065,5599,1179,6778,,13149,3370,743,4206
29161,12699,5800,18499,,13231,7273,1239,8675
29073,5670,1774,7444,,13237,6516,2745,9431
29071,35420,14625,50045,,13303,4138,4187,8422
29099,68973,36996,105969,,13319,2332,1893,4276
29186,5495,2964,8459,,13245,24441,48707,74952
29157,6907,1825,8732,,13257,7682,1835,9760
29187,17467,7247,24714,,13137,13184,2483,16128
29221,7047,2232,9279,,13139,51681,16153,70133
29189,199081,304412,503493,,13187,9613,2216,12324
29183,120899,78614,199513,,13291,9849,1962,12039
29113,18111,6746,24857,,13281,5377,1206,6726
29139,4124,1300,5424,,13241,6287,1443,7949
29007,6981,3062,10043,,13311,9751,1672,11771
29019,36146,47166,83312,,13143,9579,1474,11317
29027,13052,6075,19127,,13223,44646,18004,64601
29051,24610,12651,37261,,13233,11006,2863,14158
29131,9285,2129,11414,,13115,24045,9127,34250
29029,16721,5461,22182,,13055,6457,1612,8246
29015,7212,2372,9584,,13295,18938,4213,23939
29083,7072,2783,9855,,13047,20860,4769,26510
29013,6000,2021,8021,,13313,21514,7925,30362
20107,3377,902,4279,,13129,15171,3176,18850
20001,3575,1739,5314,,13123,10465,1955,12713
20003,2386,891,3277,,13213,10340,1799,12422
20011,4314,1604,5918,,13227,11651,1977,13982
20037,8394,6010,14404,,13083,5047,965,6238
20021,6017,2369,8386,,47115,7680,2829,10832
20099,5232,2687,7919,,47061,3626,998,4750
20125,8466,3157,11623,,47153,4434,1051,5667
20019,1552,293,1845,,47175,1820,539,2417
20035,8016,4155,12171,,47177,9535,3535,13565
20015,18781,8270,27051,,47015,4006,1126,5299
20017,964,378,1342,,47041,5164,1566,6940
20073,2146,665,2811,,47141,18981,6847,26958
20031,2990,972,3962,,47159,5485,1688,7410
20059,7025,3633,10658,,47169,2099,943,3142
20045,14308,33923,48231,,47189,39304,14356,56286
20087,5112,3039,8151,,47149,64428,36627,106518
20005,3977,2416,6393,,47117,8167,2848,11402
20013,2861,1099,3960,,47119,23781,10026,35068
20043,2601,765,3366,,47187,68160,30992,104700
29003,6665,2475,9140,,47185,7657,1842,9776
29021,21315,14248,35563,,47127,2325,496,2926
29049,7058,3139,10197,,28145,9161,1969,11374
29025,3231,1078,4309,,28103,1181,4330,5538
29033,3480,881,4361,,28105,7671,7851,16151
29041,2948,1014,3962,,28019,2763,1198,4020
29089,3277,1574,4851,,28097,2334,1775,4162
29053,5623,2353,7976,,28155,3949,1001,5024
29135,5344,1464,6808,,28159,4874,3778,8771
29141,6757,2058,8815,,28079,4775,3579,8436
29159,12792,5253,18045,,28099,7613,2668,10438
29101,13702,7385,21087,,28101,5929,2549,8594
29037,33006,17709,50715,,28123,5742,3999,9867
20091,133907,145846,279753,,28121,46168,13741,61356
20103,17387,12289,29676,,28127,7393,3871,11416
20209,15520,31947,47467,,28129,5877,1598,7556
29047,57328,51909,109237,,28063,489,3337,3859
29095,114777,179286,294063,,28001,5125,6921,12214
29107,10977,4838,15815,,28037,2685,1471,4219
29177,7103,3732,10835,,28005,4282,2688,7033
29195,5977,3268,9245,,28085,10550,4458,15193
29165,24975,21666,46641,,28113,7748,7636,15633
20121,9839,4873,14712,,28147,3374,2475,5909
29175,7529,2780,10309,,28091,7697,3572,11443
29121,5794,1785,7579,,28109,15530,2919,18893
29001,6019,4118,10137,,28045,13720,3320,17517
29103,1413,454,1867,,28047,39710,20679,62076
29045,2458,858,3316,,28059,31204,13087,45465
29111,3343,1109,4452,,1097,91087,68429,163387
29127,9418,3484,12902,,1129,6031,2366,8492
29137,3159,988,4147,,28041,4309,956,5325
29173,3969,1297,5266,,28039,8652,1013,9831
29163,5274,2101,7375,,28111,4135,1220,5432
29205,2524,728,3252,,28131,4810,1400,6368
29199,1525,443,1968,,28153,5957,3493,9534
29197,1505,428,1933,,28157,1305,2826,4174
29171,1936,406,2342,,1125,47701,31746,81708
29129,1486,253,1739,,1073,130614,151581,290111
29079,3462,951,4413,,1115,31579,5550,37937
29061,2763,926,3689,,1117,72846,22927,99208
29063,3540,1050,4590,,1037,3376,1780,5223
29075,2304,729,3033,,1051,27619,8436,36905
29081,2965,717,3682,,1087,1394,7237,8748
29227,808,238,1046,,1123,12967,5271,18504
29147,6379,3060,9439,,1121,20596,12108,33218
29005,2059,664,2723,,1127,24208,4486,29243
29087,1926,422,2348,,1133,9225,871,10255
29117,4879,1529,6408,,13259,805,1220,2053
29115,4084,1488,5572,,13239,575,461,1044
29211,1884,600,2484,,13243,1270,1597,2895
20085,3888,1839,5727,,13273,1872,2267,4179
20131,4066,959,5025,,13095,10227,23224,33925
20117,3250,1328,4578,,13177,10641,3166,14106
20149,7451,2908,10359,,13261,5275,5520,10973
20161,9817,10658,20475,,13249,1472,401,1909
20027,2831,896,3727,,13307,630,471,1114
20029,2856,975,3831,,13321,6144,2015,8266
20089,1204,279,1483,,13275,11225,7138,18730
20123,2216,608,2824,,13201,1888,622,2540
20105,1168,280,1448,,13099,2552,2165,4782
20053,1933,693,2626,,13253,2343,1186,3577
20009,7766,2322,10088,,1109,7681,5039,13025
20145,1872,730,2602,,,,,
20047,1033,275,1308,,,,,
20057,4994,2431,7425,,,,,
20025,813,170,983,,,,,
20033,705,152,857,,,,,
20007,1822,387,2209,,,,,
20077,1950,563,2513,,,,,
20095,2507,774,3281,,,,,
20151,2824,982,3806,,,,,
20097,855,168,1023,,,,,
20155,15100,8348,23448,,,,,
20079,8503,6037,14540,,,,,
20113,8407,4036,12443,,,,,
20041,5905,2103,8008,,,,,
20061,4116,3013,7129,,,,,
20127,1790,778,2568,,,,,
20111,6354,5391,11745,,,,,
20139,4713,2181,6894,,,,,
20177,35349,38299,73648,,,,,
20197,2358,982,3340,,,,,
20115,3928,1537,5465,,,,,
20169,13367,7839,21206,,,,,
20143,2261,605,2866,,,,,
20159,2652,915,3567,,,,,
20185,1485,399,1884,,,,,
20173,101319,79431,180750,,,,,
20191,6844,2650,9494,,,,,
40053,1827,373,2200,,,,,
40003,1931,325,2256,,,,,
40047,15998,5694,21692,,,,,
40071,12168,4627,16795,,,,,
40103,3707,1163,4870,,,,,
40083,13613,5335,18948,,,,,
40073,5151,972,6123,,,,,
40093,2940,459,3399,,,,,
40043,1964,282,2246,,,,,
40045,1610,216,1826,,,,,
40007,1987,250,2237,,,,,
20119,1390,285,1675,,,,,
20069,1651,360,2011,,,,,
20055,6155,3576,9731,,,,,
20067,1755,556,2311,,,,,
20075,690,157,847,,,,,
20071,523,116,639,,,,,
20199,711,68,779,,,,,
20109,1124,224,1348,,,,,
20063,1127,201,1328,,,,,
20065,1013,252,1265,,,,,
20137,1808,382,2190,,,,,
20039,1220,240,1460,,,,,
20153,1209,239,1448,,,,,
20023,1172,237,1409,,,,,
20181,2043,494,2537,,,,,
20193,2832,651,3483,,,,,
20179,1186,176,1362,,,,,
20147,2200,411,2611,,,,,
20163,1999,379,2378,,,,,
20051,8311,3349,11660,,,,,
20135,1216,219,1435,,,,,
20083,845,161,1006,,,,,
20101,684,147,831,,,,,
20171,1832,327,2159,,,,,
20093,1048,277,1325,,,,,
20081,1011,289,1300,,,,,
20175,3025,1718,4743,,,,,
20189,1564,289,1853,,,,,
20129,970,190,1160,,,,,
20187,580,162,742,,,,,
40025,962,115,1077,,,,,
40139,4615,1156,5771,,,,,
48195,1730,217,1947,,,,,
48233,7039,1087,8126,,,,,
48065,2617,328,2945,,,,,
48011,924,93,1017,,,,,
48045,625,109,734,,,,,
48129,1225,235,1460,,,,,
48087,983,171,1154,,,,,
48179,6495,865,7360,,,,,
48211,1460,227,1687,,,,,
40129,1546,212,1758,,,,,
48483,2087,219,2306,,,,,
48393,524,26,550,,,,,
48295,1159,163,1322,,,,,
48357,2628,353,2981,,,,,
48191,891,198,1089,,,,,
48345,571,49,620,,,,,
48153,1473,485,1958,,,,,
48189,6347,2455,8802,,,,,
48069,1413,583,1996,,,,,
48117,2911,1290,4201,,,,,
48359,850,95,945,,,,,
48205,1727,218,1945,,,,,
48111,1258,277,1535,,,,,
48341,3974,1288,5262,,,,,
48375,19499,8831,28330,,,,,
48381,43379,10434,53813,,,,,
48437,1671,519,2190,,,,,
48421,807,126,933,,,,,
48369,1911,907,2818,,,,,
48017,1343,441,1784,,,,,
48079,679,222,901,,,,,
48219,5793,1489,7282,,,,,
48279,3040,865,3905,,,,,
48303,65566,32494,98060,,,,,
48305,1546,451,1997,,,,,
48445,1295,468,1763,,,,,
48501,1797,502,2299,,,,,
20203,765,169,934,,,,,
20165,1177,297,1474,,,,,
20167,2544,604,3148,,,,,
20141,1437,316,1753,,,,,
20183,1635,379,2014,,,,,
20195,1211,248,1459,,,,,
40059,1307,178,1485,,,,,
40151,2945,720,3665,,,,,
40153,6329,1244,7573,,,,,
40109,141429,132180,273609,,,,,
40081,10838,3163,14001,,,,,
40037,21539,7247,28786,,,,,
40107,2791,1142,3933,,,,,
40063,3387,1138,4525,,,,,
40029,1892,501,2393,,,,,
40069,3081,920,4001,,,,,
40099,4173,1352,5525,,,,,
40123,10420,4394,14814,,,,,
40125,17826,7591,25417,,,,,
40133,5612,2420,8032,,,,,
40121,12740,4510,17250,,,,,
40061,3697,1037,4734,,,,,
40077,3094,956,4050,,,,,
40079,13346,3853,17199,,,,,
5131,28769,14788,43557,,,,,
40135,10888,3549,14437,,,,,
40001,4753,1715,6468,,,,,
5143,40418,37735,78153,,,,,
40021,9992,6495,16487,,,,,
40041,11796,3884,15680,,,,,
29119,6599,1634,8233,,,,,
29009,11427,3177,14604,,,,,
29109,13084,3590,16674,,,,,
29043,30941,10453,41394,,,,,
29067,5486,1178,6664,,,,,
29091,13888,3527,17415,,,,,
29153,3639,862,4501,,,,,
29213,18240,5159,23399,,,,,
29209,13149,3389,16538,,,,,
29203,2966,938,3904,,,,,
29179,2402,630,3032,,,,,
29223,4640,1098,5738,,,,,
29207,11077,2201,13278,,,,,
29215,8875,2060,10935,,,,,
29105,12834,3125,15959,,,,,
29059,5895,1545,7440,,,,,
29077,77387,50222,127609,,,,,
29057,3184,767,3951,,,,,
29011,4958,974,5932,,,,,
29039,5019,1259,6278,,,,,
29167,10435,3274,13709,,,,,
29085,3539,1178,4717,,,,,
29185,3501,1129,4630,,,,,
29217,6526,2050,8576,,,,,
29097,35058,13121,48179,,,,,
29145,20546,5960,26506,,,,,
40115,7627,3059,10686,,,,,
40035,4279,1499,5778,,,,,
40097,11550,4162,15712,,,,,
40131,30893,9941,40834,,,,,
40105,3321,916,4237,,,,,
40147,15810,6398,22208,,,,,
40113,12559,6383,18942,,,,,
40117,4716,1630,6346,,,,,
40119,16644,11105,27749,,,,,
40143,143985,102572,246557,,,,,
40111,8926,4998,13924,,,,,
40091,5501,2457,7958,,,,,
40101,15029,9164,24193,,,,,
40145,22967,8279,31246,,,,,
29225,12829,3861,16690,,,,,
29229,6703,1383,8086,,,,,
29169,9870,3573,13443,,,,,
29125,3559,939,4498,,,,,
29151,5845,1233,7078,,,,,
40127,3581,902,4483,,,,,
20157,1993,491,2484,,,,,
20201,2136,541,2677,,,,,
20207,1063,357,1420,,,,,
20133,4340,1811,6151,,,,,
20205,2747,735,3482,,,,,
20049,1048,211,1259,,,,,
29219,11109,4657,15766,,,,,
29510,20281,107122,127403,,,,,
29181,4520,998,5518,,,,,
5137,4081,1446,5527,,,,,
5129,2955,743,3698,,,,,
5101,2875,856,3731,,,,,
5071,6072,2925,8997,,,,,
5115,15694,5851,21545,,,,,
5141,5382,1729,7111,,,,,
5149,4600,1789,6389,,,,,
5133,3281,1236,4517,,,,,
48337,7526,1078,8604,,,,,
48077,4376,635,5011,,,,,
48237,2973,366,3339,,,,,
48367,46433,9980,56413,,,,,
48439,345683,317149,662832,,,,,
48497,20655,4006,24661,,,,,
48503,6587,1071,7658,,,,,
48429,3033,420,3453,,,,,
48425,3206,670,3876,,,,,
40149,3851,777,4628,,,,,
48495,1403,470,1873,,,,,
48301,57,7,64,,,,,
48389,1417,1767,3184,,,,,
48109,280,482,762,,,,,
48229,503,368,871,,,,,
48141,54567,155891,210458,,,,,
48243,694,481,1175,,,,,
48043,2073,2153,4226,,,,,
48371,2463,1704,4167,,,,,
48443,287,150,437,,,,,
48465,5856,7620,13476,,,,,
48271,936,488,1424,,,,,
48323,2816,10772,13588,,,,,
48127,974,2251,3225,,,,,
48163,1232,1451,2683,,,,,
48283,870,1179,2049,,,,,
48131,1316,2843,4159,,,,,
48047,613,1983,2596,,,,,
48215,48608,124382,172990,,,,,
48061,29432,62372,91804,,,,,
48489,1541,3541,5082,,,,,
48261,84,102,186,,,,,
48273,4364,5119,9483,,,,,
48249,5411,6935,12346,,,,,
48297,3450,817,4267,,,,,
48311,454,43,497,,,,,
48479,12946,43921,56867,,,,,
48247,430,1689,2119,,,,,
48427,2218,9473,11691,,,,,
48505,1028,2106,3134,,,,,
48409,13004,8509,21513,,,,,
48007,7730,2737,10467,,,,,
48057,4638,2319,6957,,,,,
48239,4266,1009,5275,,,,,
48285,7339,1294,8633,,,,,
48469,21253,9779,31032,,,,,
48391,1830,1115,2945,,,,,
48321,8147,3632,11779,,,,,
48481,10149,4558,14707,,,,,
48355,50704,53254,103958,,,,,
48325,12054,5133,17187,,,,,
48463,4828,4108,8936,,,,,
48385,1382,296,1678,,,,,
48507,692,2698,3390,,,,,
48435,1075,340,1415,,,,,
48475,2541,872,3413,,,,,
48377,652,1551,2203,,,,,
48299,8283,2094,10377,,,,,
48411,2025,329,2354,,,,,
48281,6371,1778,8149,,,,,
48193,3056,553,3609,,,,,
48333,1949,289,2238,,,,,
22097,21966,18004,39970,,,,,
22099,16872,8877,25749,,,,,
22101,14353,8518,22871,,,,,
22109,31900,11993,43893,,,,,
22057,31958,9686,41644,,,,,
22051,100292,81096,181388,,,,,
22071,24267,141352,165619,,,,,
22075,6900,3672,10572,,,,,
22087,10232,5575,15807,,,,,
22103,90914,33475,124389,,,,,
22105,33933,18448,52381,,,,,
22063,48797,8903,57700,,,,,
22033,84620,111712,196332,,,,,
22037,5569,4473,10042,,,,,
22091,2497,3467,5964,,,,,
22121,6926,5784,12710,,,,,
22125,3390,2408,5798,,,,,
22095,7569,13171,20740,,,,,
22089,16620,9570,26190,,,,,
22093,5456,6629,12085,,,,,
22117,12552,6070,18622,,,,,
22107,1180,1363,2543,,,,,
5145,21038,6413,27451,,,,,
5147,1344,1206,2550,,,,,
5123,3195,4217,7412,,,,,
